date;prim_capt;sec_capt;all_capt;time_interval;time_interval2;
1;15/03/1994;1;1;1;1;0
2;16/03/1994;1;2;2;1;1
3;17/03/1994;1;3;3;1;2
4;22/03/1994;2;1;4;5;7
5;23/03/1994;2;2;5;1;8
6;24/03/1994;2;3;6;1;9
7;04/05/1994;3;1;7;41;50
8;05/05/1994;3;2;8;1;51
9;06/05/1994;3;3;9;1;52
10;09/06/1994;4;1;10;34;86
11;10/06/1994;4;2;11;1;87
12;11/06/1994;4;3;12;1;88
13;28/06/1994;5;1;13;17;105
14;29/06/1994;5;2;14;1;106
15;30/06/1994;5;3;15;1;107
16;19/07/1994;6;1;16;19;126
17;20/07/1994;6;2;17;1;127
18;21/07/1994;6;3;18;1;128
19;26/07/1994;7;1;19;5;133
20;27/07/1994;7;2;20;1;134
21;28/07/1994;7;3;21;1;135
22;06/09/1994;8;1;22;40;175
23;07/09/1994;8;2;23;1;176
24;08/09/1994;8;3;24;1;177
25;04/10/1994;9;1;25;26;203
26;05/10/1994;9;2;26;1;204
27;06/10/1994;9;3;27;1;205
28;02/11/1994;10;1;28;27;232
29;03/11/1994;10;2;29;1;233
30;04/11/1994;10;3;30;1;234
31;15/11/1994;11;1;31;11;245
32;16/11/1994;11;2;32;1;246
33;17/11/1994;11;3;33;1;247
34;13/12/1994;12;1;34;26;273
35;14/12/1994;12;2;35;1;274
36;15/12/1994;12;3;36;1;275
37;10/01/1995;13;1;37;26;301
38;11/01/1995;13;2;38;1;302
39;12/01/1995;13;3;39;1;303
40;07/02/1995;14;1;40;26;329
41;08/02/1995;14;2;41;1;330
42;09/02/1995;14;3;42;1;331
43;02/03/1995;15;1;43;21;352
44;03/03/1995;15;2;44;1;353
45;04/03/1995;15;3;45;1;354
46;04/04/1995;16;1;46;31;385
47;05/04/1995;16;2;47;1;386
48;06/04/1995;16;3;48;1;387
49;02/05/1995;17;1;49;26;413
50;03/05/1995;17;2;50;1;414
51;04/05/1995;17;3;51;1;415
52;30/05/1995;18;1;52;26;441
53;31/05/1995;18;2;53;1;442
54;01/06/1995;18;3;54;1;443
55;01/08/1995;19;1;55;61;504
56;02/08/1995;19;2;56;1;505
57;03/08/1995;19;3;57;1;506
58;06/08/1995;20;1;58;3;509
59;07/08/1995;20;2;59;1;510
60;08/08/1995;20;3;60;1;511
61;12/09/1995;21;1;61;35;546
62;13/09/1995;21;2;62;1;547
63;14/09/1995;21;3;63;1;548
64;27/09/1995;22;1;64;13;561
65;28/09/1995;22;2;65;1;562
66;29/09/1995;22;3;66;1;563
67;27/10/1995;23;1;67;28;591
68;28/10/1995;23;2;68;1;592
69;29/10/1995;23;3;69;1;593
70;22/11/1995;24;1;70;24;617
71;23/11/1995;24;2;71;1;618
72;24/11/1995;24;3;72;1;619
73;19/12/1995;25;1;73;25;644
74;20/12/1995;25;2;74;1;645
75;21/12/1995;25;3;75;1;646
76;16/01/1996;26;1;76;26;672
77;17/01/1996;26;2;77;1;673
78;18/01/1996;26;3;78;1;674
79;13/02/1996;27;1;79;26;700
80;14/02/1996;27;2;80;1;701
81;15/02/1996;27;3;81;1;702
82;18/02/1996;28;1;82;3;705
83;19/02/1996;28;2;83;1;706
84;20/02/1996;28;3;84;1;707
85;15/03/1996;29;1;85;24;731
86;16/03/1996;29;2;86;1;732
87;17/03/1996;29;3;87;1;733
88;10/04/1996;30;1;88;24;757
89;11/04/1996;30;2;89;1;758
90;12/04/1996;30;3;90;1;759
91;07/05/1996;31;1;91;25;784
92;08/05/1996;31;2;92;1;785
93;09/05/1996;31;3;93;1;786
94;06/06/1996;32;1;94;28;814
95;07/06/1996;32;2;95;1;815
96;08/06/1996;32;3;96;1;816
97;10/07/1996;33;1;97;32;848
98;11/07/1996;33;2;98;1;849
99;12/07/1996;33;3;99;1;850
100;17/07/1996;34;1;100;5;855
101;18/07/1996;34;2;101;1;856
102;19/07/1996;34;3;102;1;857
103;06/08/1996;35;1;103;18;875
104;07/08/1996;35;2;104;1;876
105;08/08/1996;35;3;105;1;877
106;04/09/1996;36;1;106;27;904
107;05/09/1996;36;2;107;1;905
108;06/09/1996;36;3;108;1;906
109;02/10/1996;37;1;109;26;932
110;03/10/1996;37;2;110;1;933
111;04/10/1996;37;3;111;1;934
112;05/11/1996;38;1;112;32;966
113;06/11/1996;38;2;113;1;967
114;07/11/1996;38;3;114;1;968
115;03/12/1996;39;1;115;26;994
116;04/12/1996;39;2;116;1;995
117;05/12/1996;39;3;117;1;996
118;07/01/1997;40;1;118;33;1029
119;08/01/1997;40;2;119;1;1030
120;09/01/1997;40;3;120;1;1031
121;28/01/1997;41;1;121;19;1050
122;29/01/1997;41;2;122;1;1051
123;30/01/1997;41;3;123;1;1052
124;25/02/1997;42;1;124;26;1078
125;26/02/1997;42;2;125;1;1079
126;27/02/1997;42;3;126;1;1080
127;28/03/1997;43;1;127;29;1109
128;29/03/1997;43;2;128;1;1110
129;30/03/1997;43;3;129;1;1111
130;24/04/1997;44;1;130;25;1136
131;25/04/1997;44;2;131;1;1137
132;26/04/1997;44;3;132;1;1138
133;20/05/1997;45;1;133;24;1162
134;21/05/1997;45;2;134;1;1163
135;22/05/1997;45;3;135;1;1164
136;17/06/1997;46;1;136;26;1190
137;18/06/1997;46;2;137;1;1191
138;19/06/1997;46;3;138;1;1192
139;15/07/1997;47;1;139;26;1218
140;16/07/1997;47;2;140;1;1219
141;17/07/1997;47;3;141;1;1220
142;12/08/1997;48;1;142;26;1246
143;13/08/1997;48;2;143;1;1247
144;14/08/1997;48;3;144;1;1248
145;09/09/1997;49;1;145;26;1274
146;10/09/1997;49;2;146;1;1275
147;11/09/1997;49;3;147;1;1276
148;07/10/1997;50;1;148;26;1302
149;08/10/1997;50;2;149;1;1303
150;09/10/1997;50;3;150;1;1304
151;05/11/1997;51;1;151;27;1331
152;06/11/1997;51;2;152;1;1332
153;07/11/1997;51;3;153;1;1333
154;02/12/1997;52;1;154;25;1358
155;03/12/1997;52;2;155;1;1359
156;04/12/1997;52;3;156;1;1360
157;29/12/1997;53;1;157;25;1385
158;30/12/1997;53;2;158;1;1386
159;31/12/1997;53;3;159;1;1387
160;27/01/1998;54;1;160;27;1414
161;28/01/1998;54;2;161;1;1415
162;29/01/1998;54;3;162;1;1416
163;25/02/1998;55;1;163;27;1443
164;26/02/1998;55;2;164;1;1444
165;27/02/1998;55;3;165;1;1445
166;24/03/1998;56;1;166;25;1470
167;25/03/1998;56;2;167;1;1471
168;26/03/1998;56;3;168;1;1472
169;21/04/1998;57;1;169;26;1498
170;22/04/1998;57;2;170;1;1499
171;23/04/1998;57;3;171;1;1500
172;19/05/1998;58;1;172;26;1526
173;20/05/1998;58;2;173;1;1527
174;21/05/1998;58;3;174;1;1528
175;16/06/1998;59;1;175;26;1554
176;17/06/1998;59;2;176;1;1555
177;18/06/1998;59;3;177;1;1556
178;14/07/1998;60;1;178;26;1582
179;15/07/1998;60;2;179;1;1583
180;16/07/1998;60;3;180;1;1584
181;11/08/1998;61;1;181;26;1610
182;12/08/1998;61;2;182;1;1611
183;13/08/1998;61;3;183;1;1612
184;08/09/1998;62;1;184;26;1638
185;09/09/1998;62;2;185;1;1639
186;10/09/1998;62;3;186;1;1640
187;06/10/1998;63;1;187;26;1666
188;07/10/1998;63;2;188;1;1667
189;08/10/1998;63;3;189;1;1668
190;03/11/1998;64;1;190;26;1694
191;04/11/1998;64;2;191;1;1695
192;05/11/1998;64;3;192;1;1696
193;01/12/1998;65;1;193;26;1722
194;02/12/1998;65;2;194;1;1723
195;03/12/1998;65;3;195;1;1724
196;29/12/1998;66;1;196;26;1750
197;30/12/1998;66;2;197;1;1751
198;31/12/1998;66;3;198;1;1752
199;26/01/1999;67;1;199;26;1778
200;27/01/1999;67;2;200;1;1779
201;28/01/1999;67;3;201;1;1780
202;23/02/1999;68;1;202;26;1806
203;24/02/1999;68;2;203;1;1807
204;25/02/1999;68;3;204;1;1808
205;10/03/1999;69;1;205;13;1821
206;11/03/1999;69;2;206;1;1822
207;12/03/1999;69;3;207;1;1823
208;21/03/1999;70;1;208;9;1832
209;22/03/1999;70;2;209;1;1833
210;23/03/1999;70;3;210;1;1834
211;06/04/1999;71;1;211;14;1848
212;07/04/1999;71;2;212;1;1849
213;08/04/1999;71;3;213;1;1850
214;18/05/1999;72;1;214;40;1890
215;19/05/1999;72;2;215;1;1891
216;20/05/1999;72;3;216;1;1892
217;15/06/1999;73;1;217;26;1918
218;16/06/1999;73;2;218;1;1919
219;17/06/1999;73;3;219;1;1920
220;13/07/1999;74;1;220;26;1946
221;14/07/1999;74;2;221;1;1947
222;15/07/1999;74;3;222;1;1948
223;10/08/1999;75;1;223;26;1974
224;11/08/1999;75;2;224;1;1975
225;12/08/1999;75;3;225;1;1976
226;07/09/1999;76;1;226;26;2002
227;08/09/1999;76;2;227;1;2003
228;09/09/1999;76;3;228;1;2004
229;05/10/1999;77;1;229;26;2030
230;06/10/1999;77;2;230;1;2031
231;07/10/1999;77;3;231;1;2032
232;02/11/1999;78;1;232;26;2058
233;03/11/1999;78;2;233;1;2059
234;04/11/1999;78;3;234;1;2060
235;30/11/1999;79;1;235;26;2086
236;01/12/1999;79;2;236;1;2087
237;02/12/1999;79;3;237;1;2088
238;28/12/1999;80;1;238;26;2114
239;29/12/1999;80;2;239;1;2115
240;30/12/1999;80;3;240;1;2116
241;25/01/2000;81;1;241;26;2142
242;26/01/2000;81;2;242;1;2143
243;27/01/2000;81;3;243;1;2144
244;22/02/2000;82;1;244;26;2170
245;23/02/2000;82;2;245;1;2171
246;24/02/2000;82;3;246;1;2172
247;21/03/2000;83;1;247;26;2198
248;22/03/2000;83;2;248;1;2199
249;23/03/2000;83;3;249;1;2200
250;18/04/2000;84;1;250;26;2226
251;19/04/2000;84;2;251;1;2227
252;20/04/2000;84;3;252;1;2228
253;16/05/2000;85;1;253;26;2254
254;17/05/2000;85;2;254;1;2255
255;18/05/2000;85;3;255;1;2256
256;13/06/2000;86;1;256;26;2282
257;14/06/2000;86;2;257;1;2283
258;15/06/2000;86;3;258;1;2284
259;11/07/2000;87;1;259;26;2310
260;12/07/2000;87;2;260;1;2311
261;13/07/2000;87;3;261;1;2312
262;08/08/2000;88;1;262;26;2338
263;09/08/2000;88;2;263;1;2339
264;10/08/2000;88;3;264;1;2340
265;05/09/2000;89;1;265;26;2366
266;06/09/2000;89;2;266;1;2367
267;07/09/2000;89;3;267;1;2368
268;03/10/2000;90;1;268;26;2394
269;04/10/2000;90;2;269;1;2395
270;05/10/2000;90;3;270;1;2396
271;31/10/2000;91;1;271;26;2422
272;01/11/2000;91;2;272;1;2423
273;02/11/2000;91;3;273;1;2424
274;28/11/2000;92;1;274;26;2450
275;29/11/2000;92;2;275;1;2451
276;30/11/2000;92;3;276;1;2452
277;27/12/2000;93;1;277;27;2479
278;28/12/2000;93;2;278;1;2480
279;29/12/2000;93;3;279;1;2481
280;23/01/2001;94;1;280;25;2506
281;24/01/2001;94;2;281;1;2507
282;25/01/2001;94;3;282;1;2508
283;20/02/2001;95;1;283;26;2534
284;21/02/2001;95;2;284;1;2535
285;22/02/2001;95;3;285;1;2536
286;22/03/2001;96;1;286;28;2564
287;23/03/2001;96;2;287;1;2565
288;24/03/2001;96;3;288;1;2566
289;18/04/2001;97;1;289;25;2591
290;19/04/2001;97;2;290;1;2592
291;20/04/2001;97;3;291;1;2593
292;15/05/2001;98;1;292;25;2618
293;16/05/2001;98;2;293;1;2619
294;17/05/2001;98;3;294;1;2620
295;12/06/2001;99;1;295;26;2646
296;13/06/2001;99;2;296;1;2647
297;14/06/2001;99;3;297;1;2648
298;10/07/2001;100;1;298;26;2674
299;11/07/2001;100;2;299;1;2675
300;12/07/2001;100;3;300;1;2676
301;07/08/2001;101;1;301;26;2702
302;08/08/2001;101;2;302;1;2703
303;09/08/2001;101;3;303;1;2704
304;04/09/2001;102;1;304;26;2730
305;05/09/2001;102;2;305;1;2731
306;06/09/2001;102;3;306;1;2732
307;02/10/2001;103;1;307;26;2758
308;03/10/2001;103;2;308;1;2759
309;04/10/2001;103;3;309;1;2760
310;30/10/2001;104;1;310;26;2786
311;31/10/2001;104;2;311;1;2787
312;01/11/2001;104;3;312;1;2788
313;27/11/2001;105;1;313;26;2814
314;28/11/2001;105;2;314;1;2815
315;29/11/2001;105;3;315;1;2816
316;27/12/2001;106;1;316;28;2844
317;28/12/2001;106;2;317;1;2845
318;29/12/2001;106;3;318;1;2846
319;22/01/2002;107;1;319;24;2870
320;23/01/2002;107;2;320;1;2871
321;24/01/2002;107;3;321;1;2872
322;23/02/2002;108;1;322;30;2902
323;24/02/2002;108;2;323;1;2903
324;25/02/2002;108;3;324;1;2904
325;27/02/2002;109;1;325;2;2906
326;28/02/2002;109;2;326;1;2907
327;01/03/2002;109;3;327;1;2908
328;19/03/2002;110;1;328;18;2926
329;20/03/2002;110;2;329;1;2927
330;21/03/2002;110;3;330;1;2928
331;27/03/2002;111;1;331;6;2934
332;28/03/2002;111;2;332;1;2935
333;29/03/2002;111;3;333;1;2936
334;18/04/2002;112;1;334;20;2956
335;19/04/2002;112;2;335;1;2957
336;20/04/2002;112;3;336;1;2958
337;13/05/2002;113;1;337;23;2981
338;14/05/2002;113;2;338;1;2982
339;15/05/2002;113;3;339;1;2983
340;11/06/2002;114;1;340;27;3010
341;12/06/2002;114;2;341;1;3011
342;13/06/2002;114;3;342;1;3012
343;09/07/2002;115;1;343;26;3038
344;10/07/2002;115;2;344;1;3039
345;11/07/2002;115;3;345;1;3040
346;06/08/2002;116;1;346;26;3066
347;07/08/2002;116;2;347;1;3067
348;08/08/2002;116;3;348;1;3068
349;03/09/2002;117;1;349;26;3094
350;04/09/2002;117;2;350;1;3095
351;05/09/2002;117;3;351;1;3096
352;28/09/2002;118;1;352;23;3119
353;29/09/2002;118;2;353;1;3120
354;30/09/2002;118;3;354;1;3121
355;29/10/2002;119;1;355;29;3150
356;30/10/2002;119;2;356;1;3151
357;31/10/2002;119;3;357;1;3152
358;26/11/2002;120;1;358;26;3178
359;27/11/2002;120;2;359;1;3179
360;28/11/2002;120;3;360;1;3180
361;22/12/2002;121;1;361;24;3204
362;23/12/2002;121;2;362;1;3205
363;24/12/2002;121;3;363;1;3206
364;21/01/2003;122;1;364;28;3234
365;22/01/2003;122;2;365;1;3235
366;23/01/2003;122;3;366;1;3236
367;18/02/2003;123;1;367;26;3262
368;19/02/2003;123;2;368;1;3263
369;20/02/2003;123;3;369;1;3264
370;18/03/2003;124;1;370;26;3290
371;19/03/2003;124;2;371;1;3291
372;20/03/2003;124;3;372;1;3292
373;15/04/2003;125;1;373;26;3318
374;16/04/2003;125;2;374;1;3319
375;17/04/2003;125;3;375;1;3320
376;13/05/2003;126;1;376;26;3346
377;14/05/2003;126;2;377;1;3347
378;15/05/2003;126;3;378;1;3348
379;11/06/2003;127;1;379;27;3375
380;12/06/2003;127;2;380;1;3376
381;13/06/2003;127;3;381;1;3377
382;08/07/2003;128;1;382;25;3402
383;09/07/2003;128;2;383;1;3403
384;10/07/2003;128;3;384;1;3404
385;05/08/2003;129;1;385;26;3430
386;06/08/2003;129;2;386;1;3431
387;07/08/2003;129;3;387;1;3432
388;02/09/2003;130;1;388;26;3458
389;03/09/2003;130;2;389;1;3459
390;04/09/2003;130;3;390;1;3460
391;01/10/2003;131;1;391;27;3487
392;02/10/2003;131;2;392;1;3488
393;03/10/2003;131;3;393;1;3489
394;28/10/2003;132;1;394;25;3514
395;29/10/2003;132;2;395;1;3515
396;30/10/2003;132;3;396;1;3516
397;25/11/2003;133;1;397;26;3542
398;26/11/2003;133;2;398;1;3543
399;27/11/2003;133;3;399;1;3544
400;21/12/2003;134;1;400;24;3568
401;22/12/2003;134;2;401;1;3569
402;23/12/2003;134;3;402;1;3570
403;20/01/2004;135;1;403;28;3598
404;21/01/2004;135;2;404;1;3599
405;22/01/2004;135;3;405;1;3600
406;17/02/2004;136;1;406;26;3626
407;18/02/2004;136;2;407;1;3627
408;19/02/2004;136;3;408;1;3628
409;09/03/2004;137;1;409;19;3647
410;10/03/2004;137;2;410;1;3648
411;11/03/2004;137;3;411;1;3649
412;16/03/2004;138;1;412;5;3654
413;17/03/2004;138;2;413;1;3655
414;18/03/2004;138;3;414;1;3656
415;13/04/2004;139;1;415;26;3682
416;14/04/2004;139;2;416;1;3683
417;15/04/2004;139;3;417;1;3684
418;11/05/2004;140;1;418;26;3710
419;12/05/2004;140;2;419;1;3711
420;13/05/2004;140;3;420;1;3712
421;09/06/2004;141;1;421;27;3739
422;10/06/2004;141;2;422;1;3740
423;11/06/2004;141;3;423;1;3741
424;06/07/2004;142;1;424;25;3766
425;07/07/2004;142;2;425;1;3767
426;08/07/2004;142;3;426;1;3768
427;03/08/2004;143;1;427;26;3794
428;04/08/2004;143;2;428;1;3795
429;05/08/2004;143;3;429;1;3796
430;31/08/2004;144;1;430;26;3822
431;01/09/2004;144;2;431;1;3823
432;02/09/2004;144;3;432;1;3824
433;28/09/2004;145;1;433;26;3850
434;29/09/2004;145;2;434;1;3851
435;30/09/2004;145;3;435;1;3852
436;26/10/2004;146;1;436;26;3878
437;27/10/2004;146;2;437;1;3879
438;28/10/2004;146;3;438;1;3880
439;23/11/2004;147;1;439;26;3906
440;24/11/2004;147;2;440;1;3907
441;25/11/2004;147;3;441;1;3908
442;21/12/2004;148;1;442;26;3934
443;22/12/2004;148;2;443;1;3935
444;23/12/2004;148;3;444;1;3936
445;18/01/2005;149;1;445;26;3962
446;19/01/2005;149;2;446;1;3963
447;20/01/2005;149;3;447;1;3964
448;15/02/2005;150;1;448;26;3990
449;16/02/2005;150;2;449;1;3991
450;17/02/2005;150;3;450;1;3992
451;15/03/2005;151;1;451;26;4018
452;16/03/2005;151;2;452;1;4019
453;17/03/2005;151;3;453;1;4020
454;13/04/2005;152;1;454;27;4047
455;14/04/2005;152;2;455;1;4048
456;15/04/2005;152;3;456;1;4049
457;10/05/2005;153;1;457;25;4074
458;11/05/2005;153;2;458;1;4075
459;12/05/2005;153;3;459;1;4076
460;07/06/2005;154;1;460;26;4102
461;08/06/2005;154;2;461;1;4103
462;09/06/2005;154;3;462;1;4104
463;05/07/2005;155;1;463;26;4130
464;06/07/2005;155;2;464;1;4131
465;07/07/2005;155;3;465;1;4132
466;02/08/2005;156;1;466;26;4158
467;03/08/2005;156;2;467;1;4159
468;04/08/2005;156;3;468;1;4160
469;30/08/2005;157;1;469;26;4186
470;31/08/2005;157;2;470;1;4187
471;01/09/2005;157;3;471;1;4188
472;27/09/2005;158;1;472;26;4214
473;28/09/2005;158;2;473;1;4215
474;29/09/2005;158;3;474;1;4216
475;25/10/2005;159;1;475;26;4242
476;26/10/2005;159;2;476;1;4243
477;27/10/2005;159;3;477;1;4244
478;22/11/2005;160;1;478;26;4270
479;23/11/2005;160;2;479;1;4271
480;24/11/2005;160;3;480;1;4272
481;20/12/2005;161;1;481;26;4298
482;21/12/2005;161;2;482;1;4299
483;22/12/2005;161;3;483;1;4300
484;17/01/2006;162;1;484;26;4326
485;18/01/2006;162;2;485;1;4327
486;19/01/2006;162;3;486;1;4328
487;14/02/2006;163;1;487;26;4354
488;15/02/2006;163;2;488;1;4355
489;16/02/2006;163;3;489;1;4356
490;14/03/2006;164;1;490;26;4382
491;15/03/2006;164;2;491;1;4383
492;16/03/2006;164;3;492;1;4384
493;11/04/2006;165;1;493;26;4410
494;12/04/2006;165;2;494;1;4411
495;13/04/2006;165;3;495;1;4412
496;09/05/2006;166;1;496;26;4438
497;10/05/2006;166;2;497;1;4439
498;11/05/2006;166;3;498;1;4440
499;06/06/2006;167;1;499;26;4466
500;07/06/2006;167;2;500;1;4467
501;08/06/2006;167;3;501;1;4468
502;04/07/2006;168;1;502;26;4494
503;05/07/2006;168;2;503;1;4495
504;06/07/2006;168;3;504;1;4496
505;03/08/2006;169;1;505;28;4524
506;04/08/2006;169;2;506;1;4525
507;05/08/2006;169;3;507;1;4526
508;01/09/2006;170;1;508;27;4553
509;02/09/2006;170;2;509;1;4554
510;03/09/2006;170;3;510;1;4555
511;26/09/2006;171;1;511;23;4578
512;27/09/2006;171;2;512;1;4579
513;28/09/2006;171;3;513;1;4580
514;31/10/2006;172;1;514;33;4613
515;01/11/2006;172;2;515;1;4614
516;02/11/2006;172;3;516;1;4615
517;22/11/2006;173;1;517;20;4635
518;23/11/2006;173;2;518;1;4636
519;24/11/2006;173;3;519;1;4637
520;19/12/2006;174;1;520;25;4662
521;20/12/2006;174;2;521;1;4663
522;21/12/2006;174;3;522;1;4664
523;16/01/2007;175;1;523;26;4690
524;17/01/2007;175;2;524;1;4691
525;18/01/2007;175;3;525;1;4692
526;13/02/2007;176;1;526;26;4718
527;14/02/2007;176;2;527;1;4719
528;15/02/2007;176;3;528;1;4720
529;13/03/2007;177;1;529;26;4746
530;14/03/2007;177;2;530;1;4747
531;15/03/2007;177;3;531;1;4748
532;17/04/2007;178;1;532;33;4781
533;18/04/2007;178;2;533;1;4782
534;19/04/2007;178;3;534;1;4783
535;08/05/2007;179;1;535;19;4802
536;09/05/2007;179;2;536;1;4803
537;10/05/2007;179;3;537;1;4804
538;05/06/2007;180;1;538;26;4830
539;06/06/2007;180;2;539;1;4831
540;07/06/2007;180;3;540;1;4832
541;03/07/2007;181;1;541;26;4858
542;04/07/2007;181;2;542;1;4859
543;05/07/2007;181;3;543;1;4860
544;31/07/2007;182;1;544;26;4886
545;01/08/2007;182;2;545;1;4887
546;02/08/2007;182;3;546;1;4888
547;28/08/2007;183;1;547;26;4914
548;29/08/2007;183;2;548;1;4915
549;30/08/2007;183;3;549;1;4916
550;25/09/2007;184;1;550;26;4942
551;26/09/2007;184;2;551;1;4943
552;27/09/2007;184;3;552;1;4944
553;23/10/2007;185;1;553;26;4970
554;24/10/2007;185;2;554;1;4971
555;25/10/2007;185;3;555;1;4972
556;20/11/2007;186;1;556;26;4998
557;21/11/2007;186;2;557;1;4999
558;22/11/2007;186;3;558;1;5000
559;18/12/2007;187;1;559;26;5026
560;19/12/2007;187;2;560;1;5027
561;20/12/2007;187;3;561;1;5028
562;23/01/2008;188;1;562;34;5062
563;24/01/2008;188;2;563;1;5063
564;25/01/2008;188;3;564;1;5064
565;26/02/2008;189;1;565;32;5096
566;27/02/2008;189;2;566;1;5097
567;28/02/2008;189;3;567;1;5098
568;18/03/2008;190;1;568;19;5117
569;19/03/2008;190;2;569;1;5118
570;20/03/2008;190;3;570;1;5119
571;15/04/2008;191;1;571;26;5145
572;16/04/2008;191;2;572;1;5146
573;17/04/2008;191;3;573;1;5147
574;13/05/2008;192;1;574;26;5173
575;14/05/2008;192;2;575;1;5174
576;15/05/2008;192;3;576;1;5175
577;10/06/2008;193;1;577;26;5201
578;11/06/2008;193;2;578;1;5202
579;12/06/2008;193;3;579;1;5203
580;05/08/2008;194;1;580;54;5257
581;06/08/2008;194;2;581;1;5258
582;07/08/2008;194;3;582;1;5259
583;03/09/2008;195;1;583;27;5286
584;04/09/2008;195;2;584;1;5287
585;05/09/2008;195;3;585;1;5288
586;30/09/2008;196;1;586;25;5313
587;01/10/2008;196;2;587;1;5314
588;02/10/2008;196;3;588;1;5315
589;28/10/2008;197;1;589;26;5341
590;29/10/2008;197;2;590;1;5342
591;30/10/2008;197;3;591;1;5343
592;28/11/2008;198;1;592;29;5372
593;29/11/2008;198;2;593;1;5373
594;30/11/2008;198;3;594;1;5374
595;30/12/2008;199;1;595;30;5404
596;31/12/2008;199;2;596;1;5405
597;01/01/2009;199;3;597;1;5406
598;29/01/2009;200;1;598;28;5434
599;30/01/2009;200;2;599;1;5435
600;31/01/2009;200;3;600;1;5436
601;31/03/2009;201;1;601;59;5495
602;01/04/2009;201;2;602;1;5496
603;02/04/2009;201;3;603;1;5497
604;28/04/2009;202;1;604;26;5523
605;29/04/2009;202;2;605;1;5524
606;30/04/2009;202;3;606;1;5525
607;26/05/2009;203;1;607;26;5551
608;27/05/2009;203;2;608;1;5552
609;28/05/2009;203;3;609;1;5553
610;24/06/2009;204;1;610;27;5580
611;25/06/2009;204;2;611;1;5581
612;26/06/2009;204;3;612;1;5582
613;22/07/2009;205;1;613;26;5608
614;23/07/2009;205;2;614;1;5609
615;24/07/2009;205;3;615;1;5610
616;19/08/2009;206;1;616;26;5636
617;20/08/2009;206;2;617;1;5637
618;21/08/2009;206;3;618;1;5638
619;15/09/2009;207;1;619;25;5663
620;16/09/2009;207;2;620;1;5664
621;17/09/2009;207;3;621;1;5665
622;13/10/2009;208;1;622;26;5691
623;14/10/2009;208;2;623;1;5692
624;15/10/2009;208;3;624;1;5693
625;10/11/2009;209;1;625;26;5719
626;11/11/2009;209;2;626;1;5720
627;12/11/2009;209;3;627;1;5721
628;12/01/2010;210;1;628;61;5782
629;13/01/2010;210;2;629;1;5783
630;14/01/2010;210;3;630;1;5784
631;09/02/2010;211;1;631;26;5810
632;10/02/2010;211;2;632;1;5811
633;11/02/2010;211;3;633;1;5812
634;23/03/2010;212;1;634;40;5852
635;24/03/2010;212;2;635;1;5853
636;25/03/2010;212;3;636;1;5854
637;20/04/2010;213;1;637;26;5880
638;21/04/2010;213;2;638;1;5881
639;22/04/2010;213;3;639;1;5882
640;18/05/2010;214;1;640;26;5908
641;19/05/2010;214;2;641;1;5909
642;20/05/2010;214;3;642;1;5910
643;15/06/2010;215;1;643;26;5936
644;16/06/2010;215;2;644;1;5937
645;17/06/2010;215;3;645;1;5938
646;20/07/2010;216;1;646;33;5971
647;21/07/2010;216;2;647;1;5972
648;22/07/2010;216;3;648;1;5973
649;18/08/2010;217;1;649;27;6000
650;19/08/2010;217;2;650;1;6001
651;20/08/2010;217;3;651;1;6002
652;29/09/2010;218;1;652;40;6042
653;30/09/2010;218;2;653;1;6043
654;01/10/2010;218;3;654;1;6044
655;03/11/2010;219;1;655;33;6077
656;04/11/2010;219;2;656;1;6078
657;05/11/2010;219;3;657;1;6079
658;01/12/2010;220;1;658;26;6105
659;02/12/2010;220;2;659;1;6106
660;03/12/2010;220;3;660;1;6107
661;04/01/2011;221;1;661;32;6139
662;05/01/2011;221;2;662;1;6140
663;06/01/2011;221;3;663;1;6141
664;08/02/2011;222;1;664;33;6174
665;09/02/2011;222;2;665;1;6175
666;10/02/2011;222;3;666;1;6176
667;08/03/2011;223;1;667;26;6202
668;09/03/2011;223;2;668;1;6203
669;10/03/2011;223;3;669;1;6204
670;06/04/2011;224;1;670;27;6231
671;07/04/2011;224;2;671;1;6232
672;08/04/2011;224;3;672;1;6233
673;04/05/2011;225;1;673;26;6259
674;05/05/2011;225;2;674;1;6260
675;06/05/2011;225;3;675;1;6261
676;14/06/2011;226;1;676;39;6300
677;15/06/2011;226;2;677;1;6301
678;16/06/2011;226;3;678;1;6302
679;12/07/2011;227;1;679;26;6328
680;13/07/2011;227;2;680;1;6329
681;14/07/2011;227;3;681;1;6330
682;10/08/2011;228;1;682;27;6357
683;11/08/2011;228;2;683;1;6358
684;12/08/2011;228;3;684;1;6359
685;04/10/2011;229;1;685;53;6412
686;05/10/2011;229;2;686;1;6413
687;06/10/2011;229;3;687;1;6414
688;01/11/2011;230;1;688;26;6440
689;02/11/2011;230;2;689;1;6441
690;03/11/2011;230;3;690;1;6442
691;06/12/2011;231;1;691;33;6475
692;07/12/2011;231;2;692;1;6476
693;08/12/2011;231;3;693;1;6477
694;03/01/2012;232;1;694;26;6503
695;04/01/2012;232;2;695;1;6504
696;05/01/2012;232;3;696;1;6505
697;25/01/2012;233;1;697;20;6525
698;26/01/2012;233;2;698;1;6526
699;27/01/2012;233;3;699;1;6527
700;29/02/2012;234;1;700;33;6560
701;01/03/2012;234;2;701;1;6561
702;02/03/2012;234;3;702;1;6562
703;27/03/2012;235;1;703;25;6587
704;28/03/2012;235;2;704;1;6588
705;29/03/2012;235;3;705;1;6589
706;25/04/2012;236;1;706;27;6616
707;26/04/2012;236;2;707;1;6617
708;27/04/2012;236;3;708;1;6618
709;30/05/2012;237;1;709;33;6651
710;31/05/2012;237;2;710;1;6652
711;01/06/2012;237;3;711;1;6653
712;02/08/2012;238;1;712;62;6715
713;03/08/2012;238;2;713;1;6716
714;04/08/2012;238;3;714;1;6717
715;04/09/2012;239;1;715;31;6748
716;05/09/2012;239;2;716;1;6749
717;06/09/2012;239;3;717;1;6750
718;02/10/2012;240;1;718;26;6776
719;03/10/2012;240;2;719;1;6777
720;04/10/2012;240;3;720;1;6778
721;30/10/2012;241;1;721;26;6804
722;31/10/2012;241;2;722;1;6805
723;01/11/2012;241;3;723;1;6806
724;04/12/2012;242;1;724;33;6839
725;05/12/2012;242;2;725;1;6840
726;06/12/2012;242;3;726;1;6841
727;01/01/2013;243;1;727;26;6867
728;02/01/2013;243;2;728;1;6868
729;03/01/2013;243;3;729;1;6869
730;03/02/2013;244;1;730;31;6900
731;04/02/2013;244;2;731;1;6901
732;05/02/2013;244;3;732;1;6902
733;26/02/2013;245;1;733;21;6923
734;27/02/2013;245;2;734;1;6924
735;28/02/2013;245;3;735;1;6925
736;27/03/2013;246;1;736;27;6952
737;28/03/2013;246;2;737;1;6953
738;29/03/2013;246;3;738;1;6954
739;23/04/2013;247;1;739;25;6979
740;24/04/2013;247;2;740;1;6980
741;25/04/2013;247;3;741;1;6981
742;22/06/2013;248;1;742;58;7039
743;23/06/2013;248;2;743;1;7040
744;24/06/2013;248;3;744;1;7041
745;18/07/2013;249;1;745;24;7065
746;19/07/2013;249;2;746;1;7066
747;20/07/2013;249;3;747;1;7067
748;08/08/2013;250;1;748;19;7086
749;09/08/2013;250;2;749;1;7087
750;10/08/2013;250;3;750;1;7088
751;12/09/2013;251;1;751;33;7121
752;13/09/2013;251;2;752;1;7122
753;14/09/2013;251;3;753;1;7123
754;09/10/2013;252;1;754;25;7148
755;10/10/2013;252;2;755;1;7149
756;11/10/2013;252;3;756;1;7150
757;05/11/2013;253;1;757;25;7175
758;06/11/2013;253;2;758;1;7176
759;07/11/2013;253;3;759;1;7177
760;03/12/2013;254;1;760;26;7203
761;04/12/2013;254;2;761;1;7204
762;05/12/2013;254;3;762;1;7205
763;31/12/2013;255;1;763;26;7231
764;01/01/2014;255;2;764;1;7232
765;02/01/2014;255;3;765;1;7233
766;28/01/2014;256;1;766;26;7259
767;29/01/2014;256;2;767;1;7260
768;30/01/2014;256;3;768;1;7261
769;25/02/2014;257;1;769;26;7287
770;26/02/2014;257;2;770;1;7288
771;27/02/2014;257;3;771;1;7289
772;25/03/2014;258;1;772;26;7315
773;26/03/2014;258;2;773;1;7316
774;27/03/2014;258;3;774;1;7317
775;22/04/2014;259;1;775;26;7343
776;23/04/2014;259;2;776;1;7344
777;24/04/2014;259;3;777;1;7345
778;20/05/2014;260;1;778;26;7371
779;21/05/2014;260;2;779;1;7372
780;22/05/2014;260;3;780;1;7373
781;19/06/2014;261;1;781;28;7401
782;20/06/2014;261;2;782;1;7402
783;21/06/2014;261;3;783;1;7403
784;24/07/2014;262;1;784;33;7436
785;25/07/2014;262;2;785;1;7437
786;26/07/2014;262;3;786;1;7438
787;13/08/2014;263;1;787;18;7456
788;14/08/2014;263;2;788;1;7457
789;15/08/2014;263;3;789;1;7458
790;10/09/2014;264;1;790;26;7484
791;11/09/2014;264;2;791;1;7485
792;12/09/2014;264;3;792;1;7486
793;08/10/2014;265;1;793;26;7512
794;09/10/2014;265;2;794;1;7513
795;10/10/2014;265;3;795;1;7514
796;04/11/2014;266;1;796;25;7539
797;05/11/2014;266;2;797;1;7540
798;06/11/2014;266;3;798;1;7541
799;03/12/2014;267;1;799;27;7568
800;04/12/2014;267;2;800;1;7569
801;05/12/2014;267;3;801;1;7570
802;30/12/2014;268;1;802;25;7595
803;31/12/2014;268;2;803;1;7596
804;01/01/2015;268;3;804;1;7597
805;28/01/2015;269;1;805;27;7624
806;29/01/2015;269;2;806;1;7625
807;30/01/2015;269;3;807;1;7626
808;25/02/2015;270;1;808;26;7652
809;26/02/2015;270;2;809;1;7653
810;27/02/2015;270;3;810;1;7654
811;24/03/2015;271;1;811;25;7679
812;25/03/2015;271;2;812;1;7680
813;26/03/2015;271;3;813;1;7681
814;29/04/2015;272;1;814;34;7715
815;30/04/2015;272;2;815;1;7716
816;01/05/2015;272;3;816;1;7717
817;28/05/2015;273;1;817;27;7744
818;29/05/2015;273;2;818;1;7745
819;30/05/2015;273;3;819;1;7746
820;30/06/2015;274;1;820;31;7777
821;01/07/2015;274;2;821;1;7778
822;02/07/2015;274;3;822;1;7779
823;29/07/2015;275;1;823;27;7806
824;30/07/2015;275;2;824;1;7807
825;31/07/2015;275;3;825;1;7808
826;09/09/2015;276;1;826;40;7848
827;10/09/2015;276;2;827;1;7849
828;11/09/2015;276;3;828;1;7850
829;07/10/2015;277;1;829;26;7876
830;08/10/2015;277;2;830;1;7877
831;09/10/2015;277;3;831;1;7878
832;30/10/2015;278;1;832;21;7899
833;31/10/2015;278;2;833;1;7900
834;01/11/2015;278;3;834;1;7901
835;29/11/2015;279;1;835;28;7929
836;30/11/2015;279;2;836;1;7930
837;01/12/2015;279;3;837;1;7931
838;29/12/2015;280;1;838;28;7959
839;30/12/2015;280;2;839;1;7960
840;31/12/2015;280;3;840;1;7961
841;28/01/2016;281;1;841;28;7989
842;29/01/2016;281;2;842;1;7990
843;30/01/2016;281;3;843;1;7991
844;27/02/2016;282;1;844;28;8019
845;28/02/2016;282;2;845;1;8020
846;29/02/2016;282;3;846;1;8021
847;31/03/2016;283;1;847;31;8052
848;01/04/2016;283;2;848;1;8053
849;02/04/2016;283;3;849;1;8054
850;30/04/2016;284;1;850;28;8082
851;01/05/2016;284;2;851;1;8083
852;02/05/2016;284;3;852;1;8084
853;02/06/2016;285;1;853;31;8115
854;03/06/2016;285;2;854;1;8116
855;04/06/2016;285;3;855;1;8117
856;30/06/2016;286;1;856;26;8143
857;01/07/2016;286;2;857;1;8144
858;02/07/2016;286;3;858;1;8145
859;30/07/2016;287;1;859;28;8173
860;31/07/2016;287;2;860;1;8174
861;01/08/2016;287;3;861;1;8175
862;30/08/2016;288;1;862;29;8204
863;31/08/2016;288;2;863;1;8205
864;01/09/2016;288;3;864;1;8206
865;29/09/2016;289;1;865;28;8234
866;30/09/2016;289;2;866;1;8235
867;01/10/2016;289;3;867;1;8236
868;29/10/2016;290;1;868;28;8264
869;30/10/2016;290;2;869;1;8265
870;31/10/2016;290;3;870;1;8266
871;30/11/2016;291;1;871;30;8296
872;01/12/2016;291;2;872;1;8297
873;02/12/2016;291;3;873;1;8298
874;29/12/2016;292;1;874;27;8325
875;30/12/2016;292;2;875;1;8326
876;31/12/2016;292;3;876;1;8327
877;31/01/2017;293;1;877;31;8358
878;01/02/2017;293;2;878;1;8359
879;02/02/2017;293;3;879;1;8360
880;01/03/2017;294;1;880;27;8387
881;02/03/2017;294;2;881;1;8388
882;03/03/2017;294;3;882;1;8389
883;28/03/2017;295;1;883;25;8414
884;29/03/2017;295;2;884;1;8415
885;30/03/2017;295;3;885;1;8416
886;29/04/2017;296;1;886;30;8446
887;30/04/2017;296;2;887;1;8447
888;01/05/2017;296;3;888;1;8448
889;29/06/2017;297;1;889;59;8507
890;30/06/2017;297;2;890;1;8508
891;01/07/2017;297;3;891;1;8509
892;29/07/2017;298;1;892;28;8537
893;30/07/2017;298;2;893;1;8538
894;31/07/2017;298;3;894;1;8539
895;29/08/2017;299;1;895;29;8568
896;30/08/2017;299;2;896;1;8569
897;31/08/2017;299;3;897;1;8570
898;29/09/2017;300;1;898;29;8599
899;30/09/2017;300;2;899;1;8600
900;01/10/2017;300;3;900;1;8601
901;30/10/2017;301;1;901;29;8630
902;31/10/2017;301;2;902;1;8631
903;01/11/2017;301;3;903;1;8632
904;30/11/2017;302;1;904;29;8661
905;01/12/2017;302;2;905;1;8662
906;02/12/2017;302;3;906;1;8663
907;30/12/2017;303;1;907;28;8691
908;31/12/2017;303;2;908;1;8692
909;01/01/2018;303;3;909;1;8693
910;30/01/2018;304;1;910;29;8722
911;31/01/2018;304;2;911;1;8723
912;01/02/2018;304;3;912;1;8724
913;01/03/2018;305;1;913;28;8752
914;02/03/2018;305;2;914;1;8753
915;03/03/2018;305;3;915;1;8754
916;29/03/2018;306;1;916;26;8780
917;30/03/2018;306;2;917;1;8781
918;31/03/2018;306;3;918;1;8782
919;02/05/2018;307;1;919;32;8814
920;03/05/2018;307;2;920;1;8815
921;04/05/2018;307;3;921;1;8816
922;29/05/2018;308;1;922;25;8841
923;30/05/2018;308;2;923;1;8842
924;31/05/2018;308;3;924;1;8843
925;29/06/2018;309;1;925;29;8872
926;30/06/2018;309;2;926;1;8873
927;01/07/2018;309;3;927;1;8874
928;03/08/2018;310;1;928;33;8907
929;04/08/2018;310;2;929;1;8908
930;05/08/2018;310;3;930;1;8909
931;29/08/2018;311;1;931;24;8933
932;30/08/2018;311;2;932;1;8934
933;31/08/2018;311;3;933;1;8935
934;02/10/2018;312;1;934;32;8967
935;03/10/2018;312;2;935;1;8968
936;04/10/2018;312;3;936;1;8969
937;31/10/2018;313;1;937;27;8996
938;01/11/2018;313;2;938;1;8997
939;02/11/2018;313;3;939;1;8998
940;29/11/2018;314;1;940;27;9025
941;30/11/2018;314;2;941;1;9026
942;01/12/2018;314;3;942;1;9027
943;29/12/2018;315;1;943;28;9055
944;30/12/2018;315;2;944;1;9056
945;31/12/2018;315;3;945;1;9057
946;30/01/2019;316;1;946;30;9087
947;31/01/2019;316;2;947;1;9088
948;01/02/2019;316;3;948;1;9089
949;05/03/2019;317;1;949;32;9121
950;06/03/2019;317;2;950;1;9122
951;07/03/2019;317;3;951;1;9123
952;02/04/2019;318;1;952;26;9149
953;03/04/2019;318;2;953;1;9150
954;04/04/2019;318;3;954;1;9151
955;30/05/2019;319;1;955;56;9207
956;31/05/2019;319;2;956;1;9208
957;01/06/2019;319;3;957;1;9209
958;29/07/2019;320;1;958;58;9267
959;30/07/2019;320;2;959;1;9268
960;31/07/2019;320;3;960;1;9269
961;31/08/2019;321;1;961;31;9300
962;01/09/2019;321;2;962;1;9301
963;02/09/2019;321;3;963;1;9302
964;01/10/2019;322;1;964;29;9331
965;02/10/2019;322;2;965;1;9332
966;03/10/2019;322;3;966;1;9333
967;29/10/2019;323;1;967;26;9359
968;30/10/2019;323;2;968;1;9360
969;31/10/2019;323;3;969;1;9361
970;29/11/2019;324;1;970;29;9390
971;30/11/2019;324;2;971;1;9391
972;01/12/2019;324;3;972;1;9392
973;31/12/2019;325;1;973;30;9422
974;01/01/2020;325;2;974;1;9423
975;02/01/2020;325;3;975;1;9424
976;29/01/2020;326;1;976;27;9451
977;30/01/2020;326;2;977;1;9452
978;31/01/2020;326;3;978;1;9453
979;29/02/2020;327;1;979;29;9482
980;01/03/2020;327;2;980;1;9483
981;02/03/2020;327;3;981;1;9484
982;30/03/2020;328;1;982;28;9512
983;31/03/2020;328;2;983;1;9513
984;01/04/2020;328;3;984;1;9514
985;29/04/2020;329;1;985;28;9542
986;30/04/2020;329;2;986;1;9543
987;01/05/2020;329;3;987;1;9544
988;30/05/2020;330;1;988;29;9573
989;31/05/2020;330;2;989;1;9574
990;01/06/2020;330;3;990;1;9575
991;01/07/2020;331;1;991;30;9605
992;02/07/2020;331;2;992;1;9606
993;03/07/2020;331;3;993;1;9607
994;28/07/2020;332;1;994;25;9632
995;29/07/2020;332;2;995;1;9633
996;30/07/2020;332;3;996;1;9634
997;28/08/2020;333;1;997;29;9663
998;29/08/2020;333;2;998;1;9664
999;30/08/2020;333;3;999;1;9665
1000;29/09/2020;334;1;1000;30;9695
1001;30/09/2020;334;2;1001;1;9696
1002;01/10/2020;334;3;1002;1;9697
1003;29/10/2020;335;1;1003;28;9725
1004;30/10/2020;335;2;1004;1;9726
1005;31/10/2020;335;3;1005;1;9727
1006;27/11/2020;336;1;1006;27;9754
1007;28/11/2020;336;2;1007;1;9755
1008;29/11/2020;336;3;1008;1;9756
1009;29/12/2020;337;1;1009;30;9786
1010;30/12/2020;337;2;1010;1;9787
1011;31/12/2020;337;3;1011;1;9788
1012;29/01/2021;338;1;1012;29;9817
1013;30/01/2021;338;2;1013;1;9818
1014;31/01/2021;338;3;1014;1;9819
1015;03/03/2021;339;1;1015;31;9850
1016;04/03/2021;339;2;1016;1;9851
1017;05/03/2021;339;3;1017;1;9852
1018;26/03/2021;340;1;1018;21;9873
1019;27/03/2021;340;2;1019;1;9874
1020;28/03/2021;340;3;1020;1;9875
1021;30/04/2021;341;1;1021;33;9908
1022;01/05/2021;341;2;1022;1;9909
1023;02/05/2021;341;3;1023;1;9910
1024;29/05/2021;342;1;1024;27;9937
1025;30/05/2021;342;2;1025;1;9938
1026;31/05/2021;342;3;1026;1;9939
1027;29/06/2021;343;1;1027;29;9968
1028;30/06/2021;343;2;1028;1;9969
1029;01/07/2021;343;3;1029;1;9970
1030;28/07/2021;344;1;1030;27;9997
1031;29/07/2021;344;2;1031;1;9998
1032;30/07/2021;344;3;1032;1;9999
1033;30/08/2021;345;1;1033;31;10030
1034;31/08/2021;345;2;1034;1;10031
1035;01/09/2021;345;3;1035;1;10032
1036;29/09/2021;346;1;1036;28;10060
1037;30/09/2021;346;2;1037;1;10061
1038;01/10/2021;346;3;1038;1;10062
1039;30/10/2021;347;1;1039;29;10091
1040;31/10/2021;347;2;1040;1;10092
1041;01/11/2021;347;3;1041;1;10093
1042;02/12/2021;348;1;1042;31;10124
1043;03/12/2021;348;2;1043;1;10125
1044;04/12/2021;348;3;1044;1;10126
1045;29/12/2021;349;1;1045;25;10151
1046;30/12/2021;349;2;1046;1;10152
1047;31/12/2021;349;3;1047;1;10153
1048;29/01/2022;350;1;1048;29;10182
1049;30/01/2022;350;2;1049;1;10183
1050;31/01/2022;350;3;1050;1;10184
1051;01/03/2022;351;1;1051;29;10213
1052;02/03/2022;351;2;1052;1;10214
1053;03/03/2022;351;3;1053;1;10215
1054;29/03/2022;352;1;1054;26;10241
1055;30/03/2022;352;2;1055;1;10242
1056;31/03/2022;352;3;1056;1;10243
1057;28/04/2022;353;1;1057;28;10271
1058;29/04/2022;353;2;1058;1;10272
1059;30/04/2022;353;3;1059;1;10273
1060;30/05/2022;354;1;1060;30;10303
1061;31/05/2022;354;2;1061;1;10304
1062;01/06/2022;354;3;1062;1;10305
1063;29/06/2022;355;1;1063;28;10333
1064;30/06/2022;355;2;1064;1;10334
1065;01/07/2022;355;3;1065;1;10335
1066;29/07/2022;356;1;1066;28;10363
1067;30/07/2022;356;2;1067;1;10364
1068;31/07/2022;356;3;1068;1;10365
1069;30/08/2022;357;1;1069;30;10395
1070;31/08/2022;357;2;1070;1;10396
1071;01/09/2022;357;3;1071;1;10397
1072;30/09/2022;358;1;1072;29;10426
1073;01/10/2022;358;2;1073;1;10427
1074;02/10/2022;358;3;1074;1;10428
1075;25/10/2022;359;1;1075;23;10451
1076;26/10/2022;359;2;1076;1;10452
1077;27/10/2022;359;3;1077;1;10453
1078;22/11/2022;360;1;1078;26;10479
1079;23/11/2022;360;2;1079;1;10480
1080;24/11/2022;360;3;1080;1;10481
1081;20/12/2022;361;1;1081;26;10507
1082;21/12/2022;361;2;1082;1;10508
1083;22/12/2022;361;3;1083;1;10509
1084;24/01/2023;362;1;1084;33;10542
1085;25/01/2023;362;2;1085;1;10543
1086;26/01/2023;362;3;1086;1;10544
1087;21/02/2023;363;1;1087;26;10570
1088;22/02/2023;363;2;1088;1;10571
1089;23/02/2023;363;3;1089;1;10572
